//////////////////////////////////////////////////////////////////////////////////////////////////////
/			                         BEDROOM                                             /
/                                                                                                    /
//////////////////////////////////////////////////////////////////////////////////////////////////////
/                             leaderboard                                                            /
/                                  |                                                                 /
/  bedroom(x)		  hall of fame entrance                                                      /
/     |                            |                                                                 /
/  living room - home entrance - world - school entrance            AP Test 1            AP Test 5   /
/                                               |                       |                    |       /
/                                 DB Room - CMP School - AP Room - AP Lecture 1 - ... - AP Lecture 5 /
/                                               |                                                    /
/                                            RT Room                                                 /
//////////////////////////////////////////////////////////////////////////////////////////////////////
